----------
BBB-------
----------
P--A----GG
BBBBBB----
